.~~....^^^
..~~....^^
...~~.....
..**~~....
.***.~~...
..****~~..
******.~~.
*****...~~
.**^^.....
..^^^^^^..
