***.....^^
*****..^^^
****...^^^
..**..^^^^
..**.~~^^.
..~~~~~~..
...~~~~~**
....~~~***
......****
.......***
