**********
^^^.*****.
^^^^~~~~~~
.^^^^.**..
..^^^^**..
..^^^^*...
...^^^....
.*..^..^..
**.....^..
***.......
