......***.
....****..
.....***..
......*...
~~~~......
~~~~~..^..
~~~...*^^^
~~...**^^^
~..*****^^
....***..^
